1111111111111111111111111111111111111111111111
1C0000E000000000000000000000000000000000000001
1000000000000000C00000000000000000000000000001
1C000C000000000000000000C000000000000000000001
100000000000C000000000000000000000000000000001
1C0000000000000000000000111111000000000C000001
1000C0000000C000000011111000000000000000000001
1000000000000000000000000000000000000000000001
1C000C0000000000000000000000C00000000000000001
10P0000000000000000000000000000000000000000001
1000000000000000000000000000000000000000000001
1000000000000000000000000000000000000000000001
1000000000000000000000000000000000000000000001
1000000000000000000000000000000000000000000001
1000000000000000000000000000000000000000000001
1000000000000000000000000000000000000000000001
1000000000000000000000000000000000000000000001
1000000000000000000000000000000000000000000001
1000000000000000000000000000000000000000000001
1000000000000000000000000000000000000000000001
1111111111111111111111111111111111111111111111