11111111111
100000011111
100P0001
100000011111111
10000001
1110000001
111111111